111111111111
100000000001
100000111101
101110110001
100000111101
111111111111