11111111111111111111111
1E00000000011111C000001
11111111000011111111001
11100000001111000C00001
11100111100000000000C01
11101111101111100000001
1110000C1P0000000C00001
11111111111111111111111