111111111111
111000000111
1E00000000011111C000001
111100000011
1P0000001111
1CCCC0000001
111111111111